111111111111111111111111111111111111111111111111111111111111111111
100000000000000000000000000000000000000000000000000000000000000001
100000000000000000000000000000000000000000000000000000000000000001
10000000000000000000g000000000000000000000000000000000000000000001
1000000000000000000000000000000000000C0000000000000000000000000001
100000000000000000000000000000000000000000000000000000000000000001
100000000000000000000000000000000000000000000000000000000000000001
10000000C000000F000000000FFF00F000F1000001000000000000000000000001
10000000C000000F000000000FFF00F000F1000001000000000000000000000001
10000000C000000F000000000FFF00F000F1000001000000000000000000000001
10000000C000000F000000000FFF00F000F1000F01000000000000000000000001
10000000C000000F000000000FFF00F000F1000001000000000000000000000001
10000000C000000F000000000FFF00F000F100F001000000000000000000000001
10000000C000000F000000000FFF00F000F1000001000000000000000000000001
10000000C000000F000000000FFF00F000F10F0001000000000000000000000001
10000000C000000F000000000FFF00F000F1000001000000000000000000000001
10000000C000000F000000000FFF00F000F1000001000000000000000000000001
10000000C000000F000000000FFF00F000F10C000100E0P0000000000000000001
111111111111111111111111111111111111111111111111111111111111111111
