



111111111111111111
1E00C0000C00000001
101001010100010101
101001001100010101
1P0C0000000C0000C1
1000F00F00F10000C1
10F000F000F10000C1
1FFF0FFFFFF10000C1
111111111111111111





