



111111111111111111
1E0000000C00000001
101001010100010101
101001001100010101
1P00000000000000C1
1000000000010000C1
1000000000010000C1
1000000000010000C1
111111111111111111





