111111111111111111
11C0000000000000E1
100010000000000001
100P00000000000001
100001000000000001
100000000000000001
111111000000000011
111111000000000011
111111000000000011
111111111111111111
111111111111111111
111111111111111111
111111111111111111

