111111111111111111
11C000000FFF0000E1
100010000000000001
100P0000F000F00001
100001000000000001
100FFF00000F000001
11111100F000000011
111111000000000011
111111FF0000F0F011
111111111111111111
111111111111111111

