11111111
11C000E1
10001001
100P0001
10000101
10000001
11111111