11111111111111
10P00C00E0F001
1000C0000F0001
1000F00000C001
10000111000001
10001FFCFF1001
10F000F0000011
11111111111111