111111111
1P1000001
1010C0101
101000101
1000001E1
111111111