111111111111
1P1F0000C001
1010C0111101
101001100101
1000010001E1
101F00000101
101001000101
111111111111