111111111111
1P000F00C101
101100001101
101001100101
1000000000E1
101001111101
111101000001
111111111111