1111111111
1P10000001
1010C00101
1010000101
10000001E1
1111111111