111111111111
1P100000C001
1010C0111101
101001100101
1000010001E1
101001000101
101001000101
111111111111