111111111111
1P0F0F0F0F01
101100001101
101FFF0FF101
100000C00001
101F010F1101
1111010E00F1
111111111111