111111111111
1P000FF00101
101100001101
101F01100101
100000C000E1
101F01111101
111101000001
111111111111