111111111111
1P10F000CF01
101101111101
101001100101
1000010000E1
101001111101
111101000001
111111111111