111111111111
1P0F0F0F0F01
101100001101
101FFF000101
100000C000E1
101F01001101
1111010CFC01
111111111111