111111111111
1P000F0F0101
101100001101
101F01100101
100000C000E1
101F01001101
1111010CFC01
111111111111